"a" = (/turf/template_noop,/area/space)
"b" = (/turf/open/floor/pod/light,/area/shuttle/nt_transport_pod)
"c" = (/obj/effect/mob_spawn/human/corpse/damaged,/turf/open/floor/pod/light,/area/shuttle/nt_transport_pod)
"f" = (/obj/structure/chair/comfy/shuttle{dir = 4},/obj/machinery/power/apc/auto_name{pixel_y = 30},/obj/structure/cable/yellow{icon_state = "0-4"},/turf/open/floor/pod/light,/area/shuttle/nt_transport_pod)
"m" = (/obj/machinery/atmospherics/components/unary/shuttle/heater{dir = 4},/turf/closed/wall/mineral/titanium/nosmooth,/area/shuttle/nt_transport_pod)
"o" = (/obj/structure/closet/crate/secure/weapon,/obj/item/gun/ballistic/automatic/wt550,/obj/item/ammo_box/magazine/wt550m9{pixel_y = 12},/obj/item/ammo_box/magazine/wt550m9{pixel_y = 12},/obj/item/clothing/suit/armor/hecu,/turf/open/floor/pod/light,/area/shuttle/nt_transport_pod)
"t" = (/obj/machinery/power/smes,/turf/open/floor/pod/light,/area/shuttle/nt_transport_pod)
"x" = (/obj/structure/window/shuttle/tinted,/turf/open/floor/plating,/area/shuttle/nt_transport_pod)
"z" = (/obj/machinery/computer/shuttle/nt_transport_pod{dir = 8},/turf/open/floor/pod/light,/area/shuttle/nt_transport_pod)
"E" = (/obj/structure/chair/comfy/shuttle{dir = 4},/turf/open/floor/pod/light,/area/shuttle/nt_transport_pod)
"J" = (/obj/structure/shuttle/engine/propulsion/burst{dir = 8},/turf/template_noop,/area/shuttle/nt_transport_pod)
"M" = (/obj/structure/cable/yellow{icon_state = "0-8"},/turf/open/floor/pod/light,/area/shuttle/nt_transport_pod)
"O" = (/turf/closed/wall/mineral/titanium/nosmooth,/area/shuttle/nt_transport_pod)
"P" = (/obj/structure/chair/comfy/shuttle,/turf/open/floor/pod/light,/area/shuttle/nt_transport_pod)
"U" = (/obj/machinery/computer/camera_advanced/shuttle_docker/nt_transport_pod{dir = 8},/turf/open/floor/pod/light,/area/shuttle/nt_transport_pod)
"X" = (/obj/structure/rack/shelf,/obj/item/inducer/sci/combat,/obj/item/stock_parts/cell/bluespacereactor,/turf/open/floor/pod/light,/area/shuttle/nt_transport_pod)
"Z" = (/obj/structure/fans/tiny,/obj/machinery/door/airlock/shuttle,/turf/open/floor/plating,/area/shuttle/nt_transport_pod)

(1,1,1) = {"
aaJOOZOOaa
JmOOtbPOxx
JmEfMbcEUx
JmEEbbbbzx
JmOOooXOxx
aaJOOOOOaa
"}
