//MAP CONVERTED BY dmm2tgm.py THIS HEADER COMMENT PREVENTS RECONVERSION, DO NOT REMOVE
"al" = (
/obj/effect/decal/remains/human,
/obj/effect/decal/cleanable/blood,
/turf/open/floor/plasteel/freezer,
/area/ruin/powered)
"aE" = (
/obj/effect/mine/sound/bwoink,
/turf/open/floor/plating/asteroid/airless,
/area/ruin/powered)
"bY" = (
/obj/effect/spawner/lootdrop/salvage,
/turf/closed/mineral/random/high_chance,
/area/ruin/powered)
"dx" = (
/obj/structure/fluff/fokoff_sign,
/turf/open/floor/plating/asteroid/airless,
/area/ruin/powered)
"eo" = (
/obj/effect/decal/cleanable/dirt,
/obj/effect/decal/cleanable/dirt,
/obj/effect/decal/cleanable/dirt,
/obj/structure/spider/stickyweb,
/turf/open/floor/plasteel,
/area/ruin/powered)
"ep" = (
/obj/machinery/atmospherics/pipe/simple/scrubbers/hidden/layer1{
	dir = 4
	},
/turf/closed/wall/r_wall/rust,
/area/ruin/powered)
"fu" = (
/obj/effect/decal/cleanable/dirt,
/obj/machinery/atmospherics/components/unary/vent_pump/on,
/turf/open/floor/plasteel,
/area/ruin/powered)
"fK" = (
/obj/structure/rack/shelf,
/obj/effect/decal/cleanable/cobweb,
/turf/open/floor/plasteel/freezer,
/area/ruin/powered)
"ge" = (
/obj/structure/chair/sofa/right/brown,
/obj/effect/decal/cleanable/dirt,
/turf/open/floor/plasteel,
/area/ruin/powered)
"gY" = (
/obj/structure/table,
/obj/effect/decal/cleanable/dirt,
/obj/item/reagent_containers/spray/cleaner{
	pixel_x = 0;
	pixel_y = 4
	},
/turf/open/floor/plasteel,
/area/ruin/powered)
"hh" = (
/obj/structure/spider/stickyweb,
/turf/open/floor/plasteel,
/area/ruin/powered)
"jK" = (
/obj/effect/decal/cleanable/dirt,
/obj/structure/reagent_dispensers/fueltank,
/turf/open/floor/plasteel,
/area/ruin/powered)
"ka" = (
/obj/effect/mine/stun,
/turf/open/floor/plating/asteroid/airless,
/area/ruin/powered)
"li" = (
/turf/closed/wall/r_wall/rust,
/area/ruin/powered)
"mh" = (
/obj/machinery/porta_turret/syndicate/energy{
	mode = 1
	},
/turf/closed/wall/r_wall/rust,
/area/ruin/powered)
"mt" = (
/turf/closed/wall/rust,
/area/ruin/powered)
"mB" = (
/obj/effect/decal/cleanable/dirt,
/obj/machinery/mech_bay_recharge_port,
/turf/open/floor/plasteel,
/area/ruin/powered)
"nc" = (
/obj/machinery/door/airlock/external/abandoned_brown,
/turf/open/floor/plasteel,
/area/ruin/powered)
"og" = (
/obj/structure/table/optable,
/obj/effect/decal/cleanable/dirt,
/obj/effect/decal/cleanable/blood,
/turf/open/floor/plasteel,
/area/ruin/powered)
"pv" = (
/obj/effect/decal/cleanable/dirt,
/obj/machinery/atmospherics/pipe/simple/scrubbers/hidden/layer1{
	dir = 9
	},
/turf/open/floor/plasteel,
/area/ruin/powered)
"pA" = (
/obj/effect/decal/cleanable/dirt,
/obj/structure/table,
/obj/structure/spider/stickyweb,
/turf/open/floor/plasteel,
/area/ruin/powered)
"qk" = (
/obj/effect/decal/cleanable/dirt,
/obj/machinery/atmospherics/pipe/simple/scrubbers/hidden/layer1{
	dir = 4
	},
/turf/open/floor/plasteel,
/area/ruin/powered)
"qH" = (
/turf/open/floor/plasteel/freezer,
/area/ruin/powered)
"qV" = (
/obj/effect/decal/cleanable/dirt,
/obj/machinery/airalarm{
	dir = 1;
	pixel_y = -22
	},
/turf/open/floor/plasteel,
/area/ruin/powered)
"rH" = (
/obj/structure/table,
/obj/effect/decal/cleanable/dirt,
/obj/item/stack/sheet/mineral/gold{
	amount = 3;
	pixel_x = 6;
	pixel_y = 8
	},
/obj/item/stack/sheet/metal/fifty{
	pixel_x = -6;
	pixel_y = 8
	},
/obj/item/stack/sheet/glass/fifty{
	pixel_x = -1;
	pixel_y = 7
	},
/turf/open/floor/plasteel,
/area/ruin/powered)
"sY" = (
/obj/machinery/computer/rdconsole/production{
	dir = 4
	},
/obj/effect/decal/cleanable/dirt,
/obj/effect/decal/cleanable/cobweb,
/turf/open/floor/plasteel,
/area/ruin/powered)
"tz" = (
/obj/structure/fans/tiny,
/obj/machinery/door/airlock/external/abandoned_brown,
/turf/open/floor/plasteel,
/area/ruin/powered)
"uF" = (
/obj/effect/decal/cleanable/dirt,
/obj/effect/decal/cleanable/dirt,
/obj/machinery/atmospherics/pipe/simple/scrubbers/hidden/layer1{
	dir = 1
	},
/turf/open/floor/plasteel,
/area/ruin/powered)
"wh" = (
/obj/structure/rack/shelf,
/obj/item/organ/cyberimp/chest/reviver,
/turf/open/floor/plasteel/freezer,
/area/ruin/powered)
"xn" = (
/obj/effect/decal/cleanable/dirt,
/obj/effect/decal/cleanable/dirt,
/obj/machinery/atmospherics/components/unary/vent_scrubber/on/layer1,
/turf/open/floor/plasteel,
/area/ruin/powered)
"yf" = (
/obj/structure/rack/shelf,
/obj/item/autosurgeon{
	desc = "A device that automatically inserts an implant or organ into the user without the hassle of extensive surgery. It has a slot to insert an organ of implant. But this rusted version looks like it could only manage one implant....";
	name = "rusted autosurgeon";
	uses = 1;
	pixel_x = 0;
	pixel_y = 11
	},
/turf/open/floor/plasteel/freezer,
/area/ruin/powered)
"BB" = (
/obj/machinery/computer/operating{
	dir = 1
	},
/obj/effect/decal/cleanable/dirt,
/turf/open/floor/plasteel,
/area/ruin/powered)
"BZ" = (
/obj/effect/decal/cleanable/dirt,
/turf/open/floor/plasteel,
/area/ruin/powered)
"Cq" = (
/obj/effect/decal/cleanable/dirt,
/obj/machinery/atmospherics/pipe/simple/cyan/hidden,
/turf/open/floor/plasteel,
/area/ruin/powered)
"CZ" = (
/obj/effect/decal/cleanable/dirt,
/obj/machinery/atmospherics/pipe/simple/scrubbers/hidden/layer1{
	dir = 4
	},
/obj/structure/reagent_dispensers/watertank,
/obj/structure/spider/stickyweb,
/turf/open/floor/plasteel,
/area/ruin/powered)
"DY" = (
/obj/machinery/light{
	dir = 4
	},
/obj/effect/decal/cleanable/dirt,
/obj/structure/spider/stickyweb,
/turf/open/floor/plasteel,
/area/ruin/powered)
"EJ" = (
/turf/template_noop,
/area/template_noop)
"Fk" = (
/obj/effect/decal/cleanable/oil,
/obj/effect/decal/cleanable/dirt,
/turf/open/floor/plasteel,
/area/ruin/powered)
"Fp" = (
/obj/machinery/atmospherics/pipe/simple/scrubbers/hidden/layer1{
	dir = 4
	},
/turf/closed/mineral/random/high_chance,
/area/ruin/powered)
"FC" = (
/obj/machinery/door/airlock/freezer,
/turf/open/floor/plasteel/freezer,
/area/ruin/powered)
"Gb" = (
/obj/structure/spider/stickyweb,
/turf/open/floor/plasteel/freezer,
/area/ruin/powered)
"Ho" = (
/obj/effect/decal/cleanable/dirt,
/obj/machinery/mecha_part_fabricator,
/turf/open/floor/plasteel,
/area/ruin/powered)
"Hq" = (
/obj/effect/decal/cleanable/oil/streak,
/obj/effect/decal/cleanable/dirt,
/turf/open/floor/plasteel,
/area/ruin/powered)
"Hy" = (
/obj/structure/table,
/obj/effect/decal/cleanable/dirt,
/obj/item/organ/cyberimp/arm/surgery,
/turf/open/floor/plasteel,
/area/ruin/powered)
"Ir" = (
/obj/structure/table,
/obj/effect/decal/cleanable/dirt,
/obj/item/reagent_containers/glass/bucket{
	pixel_x = -2;
	pixel_y = 4
	},
/obj/item/reagent_containers/glass/bottle/morphine{
	pixel_x = 9;
	pixel_y = 4
	},
/obj/item/reagent_containers/syringe{
	pixel_x = 3;
	pixel_y = -3
	},
/turf/open/floor/plasteel,
/area/ruin/powered)
"Kb" = (
/obj/structure/table,
/obj/effect/decal/cleanable/dirt,
/obj/item/mmi{
	pixel_x = 4;
	pixel_y = 0
	},
/obj/item/mmi{
	pixel_x = 4;
	pixel_y = 8
	},
/turf/open/floor/plasteel,
/area/ruin/powered)
"LI" = (
/obj/structure/table,
/obj/effect/decal/cleanable/dirt,
/obj/item/storage/belt/utility/full{
	pixel_x = 2;
	pixel_y = -2
	},
/obj/item/clothing/glasses/welding{
	pixel_x = 2;
	pixel_y = 9
	},
/turf/open/floor/plasteel,
/area/ruin/powered)
"Mw" = (
/obj/effect/decal/cleanable/dirt,
/obj/structure/spider/stickyweb,
/turf/open/floor/plasteel,
/area/ruin/powered)
"Nm" = (
/turf/open/floor/plating/asteroid/airless,
/area/ruin/powered)
"Og" = (
/obj/effect/decal/cleanable/dirt,
/mob/living/simple_animal/hostile/poison/giant_spider/hunter/ice,
/turf/open/floor/plasteel,
/area/ruin/powered)
"OG" = (
/obj/effect/decal/cleanable/dirt,
/obj/structure/mecha_wreckage/ripley,
/turf/open/floor/mech_bay_recharge_floor,
/area/ruin/powered)
"PA" = (
/obj/structure/chair/sofa/left/brown,
/obj/effect/decal/cleanable/dirt,
/obj/effect/decal/cleanable/cobweb/cobweb2,
/turf/open/floor/plasteel,
/area/ruin/powered)
"QZ" = (
/obj/effect/decal/cleanable/dirt,
/obj/effect/decal/cleanable/dirt,
/turf/open/floor/plasteel,
/area/ruin/powered)
"RE" = (
/obj/machinery/atmospherics/components/unary/outlet_injector/on/layer1{
	dir = 4
	},
/turf/open/floor/plating/asteroid/airless,
/area/ruin/powered)
"Sl" = (
/obj/machinery/turretid{
	lethal = 1;
	pixel_y = -25;
	req_access = null
	},
/obj/effect/decal/cleanable/dirt,
/obj/machinery/atmospherics/pipe/simple/cyan/hidden{
	dir = 5
	},
/turf/open/floor/plasteel,
/area/ruin/powered)
"Ss" = (
/obj/structure/rack/shelf,
/obj/item/autosurgeon/breathing_tube{
	pixel_x = 0;
	pixel_y = 9
	},
/turf/open/floor/plasteel/freezer,
/area/ruin/powered)
"Ux" = (
/obj/effect/decal/cleanable/dirt,
/obj/machinery/atmospherics/components/unary/tank/air{
	dir = 8
	},
/turf/open/floor/plasteel,
/area/ruin/powered)
"UH" = (
/obj/machinery/light{
	dir = 8
	},
/obj/effect/decal/cleanable/dirt,
/obj/machinery/computer/mech_bay_power_console{
	dir = 4
	},
/turf/open/floor/plasteel,
/area/ruin/powered)
"UZ" = (
/obj/structure/table,
/obj/effect/decal/cleanable/dirt,
/obj/item/storage/backpack/duffelbag/med{
	pixel_x = 0;
	pixel_y = 15
	},
/obj/item/storage/backpack/duffelbag/med/surgery,
/turf/open/floor/plasteel,
/area/ruin/powered)
"Xi" = (
/turf/closed/mineral/random/high_chance,
/area/ruin/powered)

(1,1,1) = {"
EJ
EJ
EJ
EJ
EJ
EJ
EJ
EJ
EJ
EJ
EJ
EJ
EJ
EJ
EJ
EJ
EJ
EJ
EJ
EJ
"}
(2,1,1) = {"
EJ
EJ
EJ
EJ
EJ
EJ
Nm
Nm
aE
Nm
EJ
EJ
EJ
EJ
EJ
EJ
EJ
EJ
EJ
EJ
"}
(3,1,1) = {"
EJ
EJ
EJ
EJ
Nm
ka
Xi
Xi
Xi
Xi
RE
Nm
Nm
EJ
EJ
EJ
EJ
EJ
EJ
EJ
"}
(4,1,1) = {"
EJ
EJ
EJ
dx
Xi
Xi
Xi
Xi
Xi
Xi
Fp
Xi
ka
Nm
dx
EJ
EJ
EJ
EJ
EJ
"}
(5,1,1) = {"
EJ
EJ
Nm
Xi
Xi
li
li
li
li
li
ep
li
Xi
Xi
Nm
EJ
EJ
EJ
EJ
EJ
"}
(6,1,1) = {"
EJ
EJ
Xi
Xi
li
li
sY
UH
mB
jK
CZ
li
li
Xi
Nm
EJ
EJ
EJ
EJ
EJ
"}
(7,1,1) = {"
EJ
mh
li
li
li
Ho
Hq
QZ
OG
BZ
qk
mt
li
mh
Nm
EJ
EJ
EJ
EJ
EJ
"}
(8,1,1) = {"
EJ
li
fK
qH
li
LI
eo
QZ
xn
uF
pv
nc
hh
tz
Nm
EJ
EJ
EJ
EJ
EJ
"}
(9,1,1) = {"
EJ
li
Ss
al
FC
BZ
BZ
rH
gY
QZ
qV
mt
mt
li
Nm
EJ
EJ
EJ
EJ
EJ
"}
(10,1,1) = {"
EJ
li
yf
qH
FC
BZ
Og
Hy
Kb
QZ
Fk
mt
mt
li
Nm
EJ
EJ
EJ
EJ
EJ
"}
(11,1,1) = {"
EJ
li
wh
Gb
li
ge
BZ
Ir
UZ
QZ
Mw
nc
BZ
tz
Nm
EJ
EJ
EJ
EJ
EJ
"}
(12,1,1) = {"
EJ
mh
li
li
li
PA
BZ
BZ
fu
Cq
Sl
mt
li
mh
Nm
Nm
EJ
EJ
EJ
EJ
"}
(13,1,1) = {"
EJ
Xi
Xi
Xi
li
li
pA
DY
og
BB
Ux
li
li
bY
Xi
aE
EJ
EJ
EJ
EJ
"}
(14,1,1) = {"
EJ
EJ
Nm
Xi
Xi
li
li
li
li
li
li
li
Xi
Xi
Xi
Nm
EJ
EJ
EJ
EJ
"}
(15,1,1) = {"
EJ
EJ
EJ
ka
Xi
Xi
Xi
Xi
Xi
Xi
Xi
Xi
Xi
Xi
Nm
dx
EJ
EJ
EJ
EJ
"}
(16,1,1) = {"
EJ
EJ
EJ
dx
Nm
Nm
Nm
Xi
Xi
Xi
Xi
ka
Nm
Nm
Nm
EJ
EJ
EJ
EJ
EJ
"}
(17,1,1) = {"
EJ
EJ
EJ
EJ
EJ
EJ
Nm
aE
Nm
Nm
Nm
Nm
EJ
EJ
EJ
EJ
EJ
EJ
EJ
EJ
"}
(18,1,1) = {"
EJ
EJ
EJ
EJ
EJ
EJ
EJ
EJ
EJ
EJ
EJ
EJ
EJ
EJ
EJ
EJ
EJ
EJ
EJ
EJ
"}
(19,1,1) = {"
EJ
EJ
EJ
EJ
EJ
EJ
EJ
EJ
EJ
EJ
EJ
EJ
EJ
EJ
EJ
EJ
EJ
EJ
EJ
EJ
"}
(20,1,1) = {"
EJ
EJ
EJ
EJ
EJ
EJ
EJ
EJ
EJ
EJ
EJ
EJ
EJ
EJ
EJ
EJ
EJ
EJ
EJ
EJ
"}
