//MAP CONVERTED BY dmm2tgm.py THIS HEADER COMMENT PREVENTS RECONVERSION, DO NOT REMOVE
"ac" = (
/obj/effect/mine/gas/plasma,
/turf/open/floor/plating,
/area/ruin/space/has_grav)
"az" = (
/obj/effect/mine/shrapnel,
/turf/open/floor/plating/asteroid,
/area/ruin/space/has_grav)
"aJ" = (
/turf/template_noop,
/area/template_noop)
"bb" = (
/obj/structure/closet/bombcloset,
/turf/open/floor/plating,
/area/ruin/space/has_grav)
"bp" = (
/obj/machinery/door/airlock/titanium{
	name = "Arrivals Shuttle Airlock"
	},
/obj/structure/fans/tiny,
/obj/effect/mine/explosive,
/turf/open/floor/plating,
/area/ruin/space/has_grav)
"cq" = (
/obj/effect/mine/explosive,
/obj/effect/mob_spawn/human/hlscientist,
/turf/open/floor/plating,
/area/ruin/space/has_grav)
"eT" = (
/obj/machinery/light/broken,
/turf/open/floor/plating{
	icon_state = "plating_rust"
	},
/area/ruin/space/has_grav)
"ft" = (
/obj/effect/mine/explosive,
/turf/open/floor/plating,
/area/ruin/space/has_grav)
"fJ" = (
/obj/structure/closet/wardrobe/grey,
/turf/open/floor/mineral/titanium/blue,
/area/ruin/space/has_grav)
"gB" = (
/obj/machinery/door/airlock/titanium{
	name = "Arrivals Shuttle Airlock"
	},
/obj/structure/fans/tiny,
/turf/open/floor/plating,
/area/ruin/space/has_grav)
"gG" = (
/obj/machinery/porta_turret/syndicate/pod{
	dir = 10;
	faction = list("pirate")
	},
/turf/closed/wall/mineral/titanium,
/area/ruin/space/has_grav)
"iL" = (
/obj/effect/decal/cleanable/blood/gibs,
/turf/open/floor/plating/asteroid,
/area/ruin/space/has_grav)
"kk" = (
/obj/effect/spawner/lootdrop/salvage,
/turf/open/floor/plating/airless,
/area/ruin/space/has_grav)
"lf" = (
/obj/structure/chair/comfy/shuttle{
	dir = 1
	},
/turf/open/floor/mineral/titanium/blue,
/area/ruin/space/has_grav)
"lr" = (
/obj/item/gun/ballistic/automatic/pistol/APS,
/turf/open/floor/plating,
/area/ruin/space/has_grav)
"mE" = (
/obj/effect/decal/cleanable/blood/gibs,
/turf/open/floor/plating,
/area/ruin/space/has_grav)
"nv" = (
/obj/structure/table,
/obj/effect/turf_decal/delivery,
/obj/item/storage/toolbox/emergency{
	pixel_x = 0;
	pixel_y = 3
	},
/obj/machinery/light/broken{
	dir = 1
	},
/turf/open/floor/mineral/titanium/blue,
/area/ruin/space/has_grav)
"ny" = (
/obj/effect/mine/explosive,
/obj/effect/mob_spawn/human/doctor,
/turf/open/floor/plating,
/area/ruin/space/has_grav)
"oc" = (
/obj/structure/table,
/obj/effect/decal/cleanable/dirt,
/obj/effect/turf_decal/delivery,
/obj/item/storage/firstaid/regular{
	empty = 1;
	name = "First-Aid (empty)";
	pixel_x = 4;
	pixel_y = 2
	},
/turf/open/floor/mineral/titanium/blue,
/area/ruin/space/has_grav)
"oR" = (
/obj/item/clothing/head/helmet/space/syndicate/black/green,
/turf/open/floor/plating,
/area/ruin/space/has_grav)
"qE" = (
/obj/effect/mine/shrapnel,
/obj/effect/mob_spawn/human/skeleton,
/turf/open/floor/plating/asteroid,
/area/ruin/space/has_grav)
"so" = (
/obj/structure/lattice,
/turf/open/floor/plating,
/area/ruin/space/has_grav)
"sz" = (
/obj/structure/chair/comfy/shuttle{
	dir = 1
	},
/obj/machinery/light/small{
	dir = 4
	},
/turf/open/floor/plating{
	icon_state = "platingdmg1"
	},
/area/ruin/space/has_grav)
"sH" = (
/obj/effect/mine/explosive,
/obj/effect/mob_spawn/human/skeleton,
/turf/open/floor/plating,
/area/ruin/space/has_grav)
"tk" = (
/obj/item/clothing/suit/hazardvest{
	desc = "A high-visibility lifejacket complete with whistle and slot for oxygen tanks.";
	name = "emergency lifejacket"
	},
/obj/item/clothing/suit/hazardvest{
	desc = "A high-visibility lifejacket complete with whistle and slot for oxygen tanks.";
	name = "emergency lifejacket"
	},
/obj/item/clothing/suit/hazardvest{
	desc = "A high-visibility lifejacket complete with whistle and slot for oxygen tanks.";
	name = "emergency lifejacket"
	},
/obj/item/clothing/suit/hazardvest{
	desc = "A high-visibility lifejacket complete with whistle and slot for oxygen tanks.";
	name = "emergency lifejacket"
	},
/obj/item/clothing/suit/hazardvest{
	desc = "A high-visibility lifejacket complete with whistle and slot for oxygen tanks.";
	name = "emergency lifejacket"
	},
/obj/item/tank/internals/emergency_oxygen/double{
	pixel_x = 3
	},
/obj/item/tank/internals/emergency_oxygen/double{
	pixel_x = 3
	},
/obj/item/tank/internals/emergency_oxygen/double{
	pixel_x = 3
	},
/obj/item/tank/internals/emergency_oxygen/double{
	pixel_x = 3
	},
/obj/item/tank/internals/emergency_oxygen/double{
	pixel_x = 3
	},
/obj/item/clothing/mask/breath{
	pixel_x = -3;
	pixel_y = -3
	},
/obj/item/clothing/mask/breath{
	pixel_x = -3;
	pixel_y = -3
	},
/obj/item/clothing/mask/breath{
	pixel_x = -3;
	pixel_y = -3
	},
/obj/item/clothing/mask/breath{
	pixel_x = -3;
	pixel_y = -3
	},
/obj/item/clothing/mask/breath{
	pixel_x = -3;
	pixel_y = -3
	},
/obj/item/clothing/head/hardhat/orange{
	name = "protective hat";
	pixel_y = 9
	},
/obj/item/clothing/head/hardhat/orange{
	name = "protective hat";
	pixel_y = 9
	},
/obj/item/clothing/head/hardhat/orange{
	name = "protective hat";
	pixel_y = 9
	},
/obj/item/clothing/head/hardhat/orange{
	name = "protective hat";
	pixel_y = 9
	},
/obj/item/clothing/head/hardhat/orange{
	name = "protective hat";
	pixel_y = 9
	},
/obj/structure/closet/crate/internals,
/obj/effect/decal/cleanable/dirt,
/obj/effect/turf_decal/delivery,
/turf/open/floor/mineral/titanium/blue,
/area/ruin/space/has_grav)
"vr" = (
/obj/effect/spawner/structure/window/shuttle,
/turf/open/floor/plating,
/area/ruin/space/has_grav)
"vw" = (
/obj/item/clothing/suit/space/syndicate/green,
/turf/open/floor/plating,
/area/ruin/space/has_grav)
"wj" = (
/obj/effect/mine/explosive,
/turf/open/floor/plating/airless{
	icon_state = "platingdmg1"
	},
/area/ruin/space/has_grav)
"xi" = (
/obj/structure/closet/wardrobe/green,
/turf/open/floor/mineral/titanium/blue,
/area/ruin/space/has_grav)
"xj" = (
/obj/structure/lattice,
/obj/effect/mine/explosive,
/turf/open/floor/plating/asteroid,
/area/ruin/space/has_grav)
"xt" = (
/obj/structure/chair/comfy/shuttle{
	dir = 8
	},
/turf/open/floor/plating{
	icon_state = "platingdmg2"
	},
/area/ruin/space/has_grav)
"xu" = (
/turf/open/floor/plating/asteroid/airless,
/area/ruin/space/has_grav)
"xz" = (
/obj/effect/mine/gas/plasma,
/turf/open/floor/plating/asteroid,
/area/ruin/space/has_grav)
"yW" = (
/obj/effect/decal/cleanable/blood/gibs,
/obj/item/storage/toolbox/syndicate,
/turf/open/floor/plating,
/area/ruin/space/has_grav)
"zI" = (
/obj/effect/spawner/lootdrop/salvage,
/turf/open/floor/plating/asteroid/airless,
/area/ruin/space/has_grav)
"Ah" = (
/turf/open/floor/plating{
	icon_state = "platingdmg2"
	},
/area/ruin/space/has_grav)
"BL" = (
/turf/closed/mineral/random/high_chance,
/area/ruin/space/has_grav)
"Ei" = (
/turf/open/floor/plating/asteroid,
/area/ruin/space/has_grav)
"Eu" = (
/turf/closed/mineral,
/area/ruin/space/has_grav)
"EV" = (
/obj/effect/mine/explosive,
/turf/open/floor/plating/asteroid,
/area/ruin/space/has_grav)
"FE" = (
/turf/open/floor/mineral/titanium,
/area/ruin/space/has_grav)
"FX" = (
/turf/open/floor/plating{
	icon_state = "platingdmg1"
	},
/area/ruin/space/has_grav)
"Gd" = (
/obj/structure/closet/wardrobe/mixed,
/turf/open/floor/mineral/titanium/blue,
/area/ruin/space/has_grav)
"Go" = (
/obj/structure/lattice,
/obj/effect/mine/explosive,
/obj/effect/mob_spawn/human/corpse/wizard,
/turf/open/floor/plating,
/area/ruin/space/has_grav)
"Hb" = (
/turf/open/floor/plating/airless{
	icon_state = "platingdmg2"
	},
/area/ruin/space/has_grav)
"Ip" = (
/obj/effect/spawner/lootdrop/salvage,
/turf/open/floor/plating,
/area/ruin/space/has_grav)
"Jl" = (
/obj/structure/shuttle/engine/heater{
	dir = 4
	},
/obj/structure/window/reinforced{
	dir = 8
	},
/turf/open/floor/plating/airless,
/area/ruin/space/has_grav)
"JD" = (
/turf/closed/wall/mineral/titanium,
/area/ruin/space/has_grav)
"JN" = (
/turf/closed/wall/r_wall/syndicate{
	smooth = 2
	},
/area/ruin/space/has_grav)
"JS" = (
/obj/structure/lattice,
/turf/open/floor/plating/asteroid,
/area/ruin/space/has_grav)
"KB" = (
/obj/structure/window/shuttle,
/obj/structure/grille,
/turf/open/floor/plating,
/area/ruin/space/has_grav)
"KO" = (
/obj/structure/closet/wardrobe/black,
/turf/open/floor/mineral/titanium/blue,
/area/ruin/space/has_grav)
"Lj" = (
/turf/open/floor/plating{
	icon_state = "platingdmg3"
	},
/area/ruin/space/has_grav)
"LY" = (
/obj/effect/mine/gas/plasma,
/obj/effect/mob_spawn/human/zombie,
/turf/open/floor/plating,
/area/ruin/space/has_grav)
"Mg" = (
/turf/open/floor/plating,
/area/ruin/space/has_grav)
"MF" = (
/obj/structure/lattice,
/obj/effect/mine/explosive,
/turf/open/floor/plating,
/area/ruin/space/has_grav)
"NX" = (
/obj/machinery/porta_turret/syndicate/pod{
	dir = 9;
	faction = list("pirate")
	},
/turf/closed/wall/mineral/titanium,
/area/ruin/space/has_grav)
"Pd" = (
/obj/structure/window/reinforced{
	dir = 8
	},
/obj/effect/spawner/lootdrop/salvage,
/turf/open/floor/plating/airless,
/area/ruin/space/has_grav)
"Rv" = (
/obj/structure/chair/comfy/shuttle,
/obj/machinery/light/small{
	dir = 4
	},
/turf/open/floor/mineral/titanium/blue,
/area/ruin/space/has_grav)
"RI" = (
/turf/open/floor/mineral/titanium/blue,
/area/ruin/space/has_grav)
"Sd" = (
/obj/structure/window/reinforced{
	dir = 8
	},
/turf/open/floor/plating/airless{
	icon_state = "platingdmg3"
	},
/area/ruin/space/has_grav)
"VG" = (
/turf/open/floor/plating/airless{
	icon_state = "platingdmg3"
	},
/area/ruin/space/has_grav)
"VR" = (
/turf/open/floor/plating{
	icon_state = "plating_rust"
	},
/area/ruin/space/has_grav)
"Wf" = (
/obj/structure/shuttle/engine/propulsion{
	dir = 4
	},
/turf/open/floor/plating/airless,
/area/ruin/space/has_grav)
"Ya" = (
/obj/machinery/light,
/turf/open/floor/plating{
	icon_state = "plating_rust"
	},
/area/ruin/space/has_grav)
"Yu" = (
/obj/structure/chair/comfy/shuttle{
	dir = 8
	},
/turf/open/floor/mineral/titanium,
/area/ruin/space/has_grav)
"YH" = (
/obj/structure/fans/tiny,
/obj/machinery/door/airlock/titanium{
	name = "Arrivals Shuttle Airlock"
	},
/obj/effect/mine/explosive,
/turf/open/floor/plating,
/area/ruin/space/has_grav)
"YW" = (
/obj/effect/mine/explosive,
/turf/open/floor/plating/asteroid/airless,
/area/ruin/space/has_grav)
"ZE" = (
/obj/effect/spawner/lootdrop/salvage,
/obj/machinery/light/broken{
	dir = 1
	},
/turf/open/floor/mineral/titanium/blue,
/area/ruin/space/has_grav)

(1,1,1) = {"
aJ
aJ
aJ
aJ
aJ
aJ
aJ
aJ
aJ
aJ
aJ
aJ
aJ
aJ
aJ
aJ
aJ
aJ
aJ
aJ
aJ
Eu
aJ
aJ
aJ
aJ
aJ
aJ
aJ
aJ
aJ
aJ
aJ
aJ
aJ
"}
(2,1,1) = {"
aJ
aJ
aJ
aJ
aJ
aJ
aJ
aJ
aJ
aJ
aJ
aJ
aJ
aJ
aJ
aJ
aJ
aJ
aJ
aJ
Eu
Eu
aJ
aJ
Eu
Eu
aJ
aJ
aJ
aJ
aJ
aJ
aJ
aJ
aJ
"}
(3,1,1) = {"
aJ
aJ
xu
xu
aJ
aJ
aJ
aJ
Eu
Eu
Eu
Eu
aJ
aJ
aJ
aJ
Eu
Eu
Eu
Eu
JN
JN
Eu
Eu
Eu
Eu
Eu
aJ
aJ
aJ
aJ
aJ
aJ
aJ
aJ
"}
(4,1,1) = {"
aJ
Eu
xu
xu
xu
aJ
aJ
aJ
Eu
Eu
Eu
Eu
Eu
Eu
Eu
Eu
Eu
Eu
JN
JN
Mg
JN
JN
JN
Eu
Eu
Eu
aJ
aJ
aJ
aJ
aJ
aJ
aJ
aJ
"}
(5,1,1) = {"
Eu
Eu
xu
xu
xu
aJ
aJ
Eu
Eu
Eu
ft
Mg
Eu
JN
JN
JN
Eu
Ip
Mg
ac
Mg
Eu
Eu
Eu
JN
JN
JN
Eu
Eu
aJ
aJ
aJ
aJ
aJ
aJ
"}
(6,1,1) = {"
Eu
Eu
Eu
Eu
Eu
aJ
aJ
Eu
Eu
JN
mE
wj
mE
Mg
so
mE
Mg
MF
mE
Mg
so
Ip
ny
bb
ft
mE
JN
Eu
Eu
aJ
aJ
aJ
aJ
aJ
aJ
"}
(7,1,1) = {"
Eu
Eu
Eu
Eu
Eu
aJ
aJ
Eu
Eu
JN
Mg
sH
Ei
Ei
EV
Ei
JS
Mg
cq
Mg
ft
Ei
Ei
mE
Mg
bb
JN
Eu
Eu
aJ
aJ
aJ
aJ
aJ
aJ
"}
(8,1,1) = {"
aJ
aJ
Eu
Eu
aJ
aJ
aJ
Eu
Eu
JN
Ip
Ei
Ei
iL
Ei
Ei
xz
Ei
Ei
JS
Ei
Ei
Ei
Mg
vw
lr
Eu
JN
Eu
Eu
aJ
aJ
aJ
aJ
aJ
"}
(9,1,1) = {"
aJ
aJ
Eu
Eu
aJ
aJ
aJ
Eu
Eu
JN
Mg
az
Ei
iL
Ei
Ei
Ei
iL
xz
Ei
EV
Ei
oR
Go
Mg
so
Eu
JN
Eu
Eu
aJ
aJ
aJ
aJ
aJ
"}
(10,1,1) = {"
aJ
aJ
aJ
aJ
aJ
aJ
aJ
aJ
Eu
Eu
ft
JS
EV
Ei
xj
qE
Mg
Mg
so
Mg
Mg
Mg
Mg
Mg
bb
yW
JN
Eu
Eu
Eu
aJ
aJ
aJ
aJ
aJ
"}
(11,1,1) = {"
aJ
aJ
aJ
aJ
aJ
aJ
aJ
aJ
Eu
Eu
Eu
Mg
mE
Mg
Mg
Mg
JN
JN
mE
ft
Hb
so
ac
JN
JN
JN
JN
Eu
Eu
Eu
aJ
aJ
aJ
aJ
aJ
"}
(12,1,1) = {"
aJ
aJ
aJ
aJ
aJ
aJ
aJ
aJ
Eu
JN
Mg
VG
Mg
mE
Eu
Eu
Eu
Eu
Ip
Mg
Ip
LY
Mg
Eu
Eu
Eu
Eu
Eu
Eu
Eu
Eu
Eu
Eu
aJ
aJ
"}
(13,1,1) = {"
aJ
aJ
aJ
aJ
aJ
aJ
aJ
aJ
BL
JN
Ei
mE
BL
BL
Eu
Eu
Eu
BL
Eu
Eu
JN
JN
Eu
Eu
Eu
Eu
aJ
aJ
aJ
aJ
aJ
Eu
Eu
Eu
aJ
"}
(14,1,1) = {"
aJ
aJ
aJ
aJ
aJ
aJ
aJ
aJ
BL
BL
Ei
Ei
Eu
NX
KB
Mg
Eu
gG
Eu
Eu
Eu
Eu
Eu
Eu
Eu
Eu
aJ
aJ
aJ
aJ
Eu
Eu
Eu
Eu
Eu
"}
(15,1,1) = {"
aJ
aJ
aJ
aJ
aJ
aJ
aJ
aJ
BL
BL
Ei
Ei
Eu
JD
Ah
VR
lf
JD
Eu
YW
Eu
Eu
BL
BL
aJ
aJ
aJ
aJ
aJ
BL
Eu
Eu
Eu
xu
xu
"}
(16,1,1) = {"
aJ
aJ
aJ
aJ
aJ
aJ
aJ
aJ
BL
BL
iL
Eu
Eu
JD
Rv
Lj
sz
JD
xu
xu
Eu
Eu
BL
BL
aJ
aJ
aJ
aJ
BL
BL
Eu
Eu
BL
xu
xu
"}
(17,1,1) = {"
aJ
aJ
aJ
aJ
aJ
aJ
aJ
aJ
BL
Eu
Ei
Eu
JD
JD
JD
FX
JD
JD
JD
xu
Eu
Eu
BL
BL
aJ
aJ
aJ
BL
Eu
Eu
Eu
xu
xu
xu
aJ
"}
(18,1,1) = {"
aJ
aJ
aJ
aJ
aJ
aJ
aJ
aJ
Eu
Eu
Ei
Eu
JD
oc
Lj
VR
VR
tk
JD
xu
xu
Eu
Eu
Eu
aJ
aJ
aJ
Eu
Eu
Eu
Eu
YW
xu
xu
aJ
"}
(19,1,1) = {"
aJ
aJ
aJ
aJ
aJ
aJ
aJ
aJ
Eu
Eu
Ei
Ei
gB
FX
Yu
Yu
Yu
VR
gB
xu
xu
YW
xu
Eu
aJ
aJ
BL
Eu
Eu
zI
xu
xu
xu
xu
aJ
"}
(20,1,1) = {"
aJ
aJ
aJ
aJ
aJ
aJ
aJ
aJ
aJ
Eu
Eu
Ei
JD
ZE
VR
RI
VR
eT
JD
xu
xu
xu
xu
Eu
aJ
Eu
Eu
Eu
Eu
xu
xu
xu
aJ
aJ
aJ
"}
(21,1,1) = {"
aJ
aJ
aJ
aJ
aJ
aJ
aJ
aJ
aJ
Eu
Eu
Eu
vr
xi
Yu
VR
Yu
Lj
vr
xu
xu
xu
xu
aJ
aJ
Eu
Eu
Eu
xu
xu
xu
aJ
aJ
aJ
aJ
"}
(22,1,1) = {"
aJ
aJ
aJ
aJ
aJ
aJ
Eu
aJ
aJ
Eu
Eu
Eu
vr
KO
Lj
VR
RI
VR
vr
xu
xu
xu
YW
aJ
aJ
Eu
Eu
xu
aJ
aJ
aJ
aJ
aJ
aJ
aJ
"}
(23,1,1) = {"
aJ
aJ
aJ
aJ
aJ
aJ
aJ
aJ
Eu
Eu
Eu
BL
vr
Gd
Yu
Yu
xt
VR
vr
xu
xu
aJ
aJ
aJ
aJ
aJ
Eu
xu
aJ
aJ
aJ
aJ
aJ
xu
aJ
"}
(24,1,1) = {"
aJ
aJ
aJ
Eu
Eu
aJ
aJ
aJ
Eu
Eu
Eu
BL
vr
fJ
VR
VR
Lj
VR
vr
xu
xu
aJ
aJ
aJ
aJ
aJ
aJ
aJ
aJ
aJ
aJ
aJ
xu
xu
aJ
"}
(25,1,1) = {"
aJ
aJ
Eu
Eu
Eu
aJ
aJ
aJ
Eu
Eu
Eu
BL
JD
nv
Yu
Yu
FE
Ya
JD
xu
xu
aJ
aJ
aJ
aJ
aJ
aJ
aJ
aJ
aJ
aJ
aJ
Eu
xu
aJ
"}
(26,1,1) = {"
aJ
aJ
aJ
Eu
Eu
aJ
aJ
aJ
Eu
Eu
Eu
Eu
bp
VR
VR
VR
FE
Ah
YH
YW
xu
aJ
aJ
Eu
Eu
aJ
aJ
aJ
aJ
aJ
aJ
Eu
Eu
xu
aJ
"}
(27,1,1) = {"
aJ
aJ
aJ
aJ
aJ
aJ
aJ
aJ
aJ
Eu
Eu
Eu
JD
Jl
Sd
Jl
Pd
Jl
JD
aJ
aJ
aJ
aJ
Eu
Eu
aJ
aJ
aJ
aJ
aJ
aJ
Eu
Eu
xu
aJ
"}
(28,1,1) = {"
aJ
aJ
aJ
aJ
aJ
aJ
aJ
aJ
aJ
aJ
Eu
Eu
JD
Hb
kk
Wf
kk
VG
JD
aJ
aJ
aJ
Eu
Eu
Eu
aJ
aJ
aJ
aJ
xu
xu
Eu
Eu
xu
aJ
"}
(29,1,1) = {"
aJ
aJ
aJ
aJ
aJ
aJ
aJ
aJ
aJ
aJ
aJ
aJ
aJ
aJ
aJ
aJ
aJ
aJ
aJ
Eu
Eu
Eu
Eu
Eu
Eu
aJ
aJ
aJ
aJ
xu
Eu
Eu
Eu
xu
aJ
"}
(30,1,1) = {"
aJ
aJ
aJ
aJ
aJ
aJ
aJ
aJ
aJ
aJ
aJ
aJ
aJ
aJ
aJ
aJ
aJ
aJ
Eu
Eu
Eu
Eu
Eu
Eu
aJ
aJ
aJ
aJ
Eu
Eu
Eu
Eu
Eu
xu
aJ
"}
(31,1,1) = {"
aJ
aJ
aJ
aJ
aJ
aJ
aJ
aJ
aJ
aJ
aJ
aJ
aJ
aJ
aJ
aJ
aJ
aJ
aJ
aJ
Eu
Eu
Eu
aJ
aJ
aJ
YW
xu
Eu
Eu
Eu
Eu
Eu
xu
aJ
"}
(32,1,1) = {"
aJ
aJ
aJ
aJ
aJ
aJ
aJ
aJ
aJ
aJ
aJ
aJ
aJ
aJ
aJ
aJ
aJ
aJ
aJ
aJ
Eu
Eu
Eu
aJ
aJ
xu
xu
Eu
Eu
Eu
xu
Eu
Eu
xu
aJ
"}
(33,1,1) = {"
aJ
aJ
aJ
aJ
aJ
aJ
aJ
aJ
aJ
aJ
aJ
aJ
aJ
aJ
aJ
aJ
aJ
aJ
aJ
aJ
Eu
aJ
aJ
aJ
aJ
xu
xu
BL
Eu
aJ
xu
Eu
Eu
xu
aJ
"}
(34,1,1) = {"
aJ
aJ
aJ
aJ
aJ
aJ
aJ
aJ
aJ
aJ
aJ
aJ
aJ
aJ
aJ
aJ
aJ
aJ
aJ
aJ
aJ
aJ
aJ
Eu
aJ
Eu
BL
Eu
Eu
aJ
aJ
Eu
xu
aJ
aJ
"}
(35,1,1) = {"
aJ
aJ
aJ
aJ
aJ
aJ
aJ
aJ
aJ
aJ
aJ
aJ
aJ
aJ
aJ
aJ
aJ
aJ
aJ
aJ
aJ
aJ
aJ
aJ
aJ
Eu
Eu
aJ
aJ
aJ
aJ
aJ
aJ
aJ
aJ
"}
