//MAP CONVERTED BY dmm2tgm.py THIS HEADER COMMENT PREVENTS RECONVERSION, DO NOT REMOVE
"a" = (
/turf/template_noop,
/area/template_noop)
"b" = (
/turf/closed/mineral,
/area/ruin/space)
"c" = (
/turf/open/floor/plating/asteroid/airless,
/area/ruin/space)
"d" = (
/turf/closed/mineral,
/area/ruin/space/has_grav)
"e" = (
/turf/closed/wall,
/area/ruin/space/has_grav)
"f" = (
/turf/closed/wall/rust,
/area/ruin/space/has_grav)
"g" = (
/obj/machinery/light/broken{
	dir = 1
	},
/turf/open/floor/plasteel/sepia,
/area/ruin/space/has_grav)
"h" = (
/obj/structure/closet/crate,
/turf/open/floor/plating,
/area/ruin/space/has_grav)
"i" = (
/obj/effect/spawner/lootdrop/crate_spawner,
/turf/open/floor/plating,
/area/ruin/space/has_grav)
"j" = (
/obj/structure/barricade/wooden,
/obj/machinery/door/airlock/security,
/turf/open/floor/plasteel/sepia,
/area/ruin/space/has_grav)
"k" = (
/obj/structure/table,
/obj/item/storage/toolbox/electrical,
/turf/open/floor/plasteel/sepia,
/area/ruin/space/has_grav)
"l" = (
/obj/structure/closet/crate,
/obj/effect/spawner/lootdrop/maintenance,
/turf/open/floor/plasteel/sepia,
/area/ruin/space/has_grav)
"m" = (
/mob/living/simple_animal/hostile/retaliate/ghost,
/turf/open/floor/plating/asteroid/airless,
/area/ruin/space)
"n" = (
/obj/structure/table,
/obj/item/storage/toolbox/inteq{
	pixel_x = 0;
	pixel_y = 4
	},
/turf/open/floor/plasteel/sepia,
/area/ruin/space/has_grav)
"o" = (
/obj/structure/table,
/turf/open/floor/plasteel/sepia,
/area/ruin/space/has_grav)
"p" = (
/obj/effect/decal/cleanable/dirt,
/turf/open/floor/plasteel/sepia,
/area/ruin/space/has_grav)
"q" = (
/turf/open/floor/plasteel/sepia,
/area/ruin/space/has_grav)
"r" = (
/obj/machinery/door/airlock/external,
/obj/structure/fans/tiny,
/turf/open/floor/plasteel/sepia,
/area/ruin/space/has_grav)
"s" = (
/obj/effect/spawner/lootdrop/crate_spawner,
/turf/open/floor/plasteel/sepia,
/area/ruin/space/has_grav)
"w" = (
/mob/living/simple_animal/hostile/space_mosquito,
/turf/open/floor/plating,
/area/ruin/space/has_grav)
"A" = (
/obj/machinery/light,
/obj/structure/chair/office{
	dir = 1
	},
/turf/open/floor/plasteel/sepia,
/area/ruin/space/has_grav)
"C" = (
/obj/structure/barricade/wooden,
/turf/open/floor/plating/asteroid/airless,
/area/ruin/space)
"D" = (
/obj/structure/closet/crate,
/turf/open/floor/plasteel/sepia,
/area/ruin/space/has_grav)
"F" = (
/obj/structure/chair/office{
	dir = 4
	},
/turf/open/floor/plasteel/sepia,
/area/ruin/space/has_grav)
"G" = (
/turf/template_noop,
/area/ruin/space)
"H" = (
/obj/effect/decal/cleanable/dirt,
/obj/machinery/light{
	dir = 1
	},
/turf/open/floor/plasteel/sepia,
/area/ruin/space/has_grav)
"J" = (
/obj/machinery/light{
	dir = 1
	},
/turf/open/floor/plasteel/sepia,
/area/ruin/space/has_grav)
"K" = (
/obj/structure/barricade/wooden,
/obj/structure/door_assembly/door_assembly_extmai,
/turf/open/floor/plasteel/sepia,
/area/ruin/space/has_grav)
"P" = (
/obj/machinery/light,
/turf/open/floor/plasteel/sepia,
/area/ruin/space/has_grav)
"U" = (
/obj/effect/spawner/lootdrop/salvage,
/turf/open/floor/plating/asteroid/airless,
/area/ruin/space)
"W" = (
/obj/machinery/door/airlock/mining,
/turf/open/floor/plating,
/area/ruin/space/has_grav)
"Y" = (
/obj/effect/spawner/lootdrop/salvage,
/turf/open/floor/plasteel/sepia,
/area/ruin/space/has_grav)

(1,1,1) = {"
a
a
a
a
a
a
a
a
a
a
a
a
a
a
a
a
a
a
a
a
a
a
a
a
a
a
a
a
a
a
a
b
b
b
a
a
a
a
"}
(2,1,1) = {"
a
a
a
a
a
a
a
a
a
a
a
a
a
a
a
a
a
a
a
a
a
a
a
a
a
a
a
a
a
a
c
b
b
b
c
a
a
a
"}
(3,1,1) = {"
a
a
a
a
a
a
a
a
a
a
a
a
a
a
a
a
a
a
b
a
a
a
a
a
a
a
a
a
a
a
a
c
c
b
c
a
a
b
"}
(4,1,1) = {"
a
a
a
c
c
c
c
c
c
b
b
b
b
b
a
a
a
a
a
a
a
a
a
a
a
a
a
a
a
a
a
a
a
c
a
a
a
a
"}
(5,1,1) = {"
a
a
a
c
b
b
b
b
b
b
b
b
b
b
a
a
a
a
a
a
a
a
b
a
a
a
a
a
a
a
a
a
a
a
a
a
b
a
"}
(6,1,1) = {"
a
a
c
c
b
c
c
c
c
c
c
c
c
b
b
a
b
b
b
a
a
a
a
a
c
c
c
a
a
a
a
a
c
c
a
a
a
a
"}
(7,1,1) = {"
a
a
c
b
b
c
c
b
b
b
b
c
c
c
b
b
b
b
b
c
c
a
a
c
b
b
b
c
a
a
a
c
b
b
c
c
a
a
"}
(8,1,1) = {"
a
a
c
b
b
c
c
b
b
b
b
c
c
c
c
b
c
c
b
b
c
c
a
c
b
b
b
c
c
a
a
b
b
b
c
c
a
a
"}
(9,1,1) = {"
a
a
b
b
c
c
c
b
b
b
b
b
b
b
c
c
m
c
b
b
b
b
c
c
c
b
b
b
b
c
a
b
b
b
b
c
a
a
"}
(10,1,1) = {"
a
a
b
b
c
b
b
b
b
b
b
b
b
b
c
c
c
c
c
b
b
b
b
b
b
b
b
b
b
b
a
a
c
b
b
b
c
a
"}
(11,1,1) = {"
a
a
b
c
c
b
b
b
b
c
c
c
c
c
c
b
b
c
c
c
b
b
b
b
b
b
b
b
b
b
a
a
a
c
b
b
c
a
"}
(12,1,1) = {"
a
a
b
c
c
b
b
c
c
c
c
c
b
b
b
b
b
b
c
c
b
b
b
b
b
b
b
b
b
b
a
a
a
c
c
b
c
a
"}
(13,1,1) = {"
a
a
b
c
b
b
c
c
b
b
b
b
b
b
b
b
b
b
c
c
c
c
b
b
b
c
c
b
b
b
b
b
b
a
c
c
c
a
"}
(14,1,1) = {"
a
a
b
c
c
b
b
c
b
d
d
f
f
e
f
e
e
e
d
b
c
c
c
b
b
c
c
c
c
b
b
b
b
a
a
a
a
a
"}
(15,1,1) = {"
a
a
b
b
c
b
b
c
b
d
Y
s
s
q
p
f
Y
Y
d
b
c
U
c
b
b
c
b
c
c
c
b
b
b
a
a
a
a
a
"}
(16,1,1) = {"
a
a
b
b
c
c
b
c
b
e
H
q
q
p
D
f
q
q
e
b
c
c
c
b
b
c
b
b
b
c
c
c
b
b
b
a
a
a
"}
(17,1,1) = {"
a
a
b
b
c
c
b
b
b
e
q
q
k
n
s
e
p
q
d
b
c
c
c
b
b
c
b
b
b
b
b
c
c
c
b
a
a
a
"}
(18,1,1) = {"
a
a
b
b
c
c
b
b
b
f
e
K
f
f
e
e
q
l
e
b
b
b
c
c
c
c
b
b
b
b
b
b
b
c
b
a
a
a
"}
(19,1,1) = {"
a
a
b
b
U
c
m
b
b
d
Y
q
l
D
l
e
q
p
f
b
b
b
c
c
c
c
c
c
c
c
U
c
b
b
b
a
a
a
"}
(20,1,1) = {"
a
a
b
b
b
c
c
b
b
d
l
p
q
q
P
e
g
p
f
b
b
b
b
b
b
c
c
c
c
c
c
c
b
b
b
b
b
a
"}
(21,1,1) = {"
a
a
a
b
b
b
c
c
b
e
J
q
q
F
q
W
p
q
e
b
b
b
b
b
b
b
b
c
c
b
c
c
c
c
b
c
b
a
"}
(22,1,1) = {"
a
a
a
b
b
b
c
c
b
e
D
D
q
o
A
e
g
p
e
f
e
b
b
b
b
b
b
b
c
b
b
c
c
c
b
c
c
b
"}
(23,1,1) = {"
a
a
a
b
b
b
b
c
c
d
f
f
j
f
e
e
Y
p
r
q
r
C
c
c
C
b
b
b
c
c
b
c
c
c
b
m
c
b
"}
(24,1,1) = {"
a
a
a
a
c
b
b
b
c
d
i
h
w
f
b
e
e
d
f
e
e
b
C
c
c
c
b
b
c
c
b
b
c
c
b
b
c
b
"}
(25,1,1) = {"
a
b
a
a
c
b
b
b
c
b
b
e
f
e
b
b
b
b
b
b
b
b
C
c
c
c
c
b
b
c
c
b
c
c
c
b
c
b
"}
(26,1,1) = {"
a
a
a
a
c
b
b
b
c
b
b
b
b
b
b
c
b
b
b
b
b
b
b
b
b
c
c
b
b
b
c
b
c
c
c
b
c
b
"}
(27,1,1) = {"
a
a
a
a
c
b
b
b
c
c
b
b
b
c
c
c
b
c
b
b
b
b
b
b
b
b
c
c
b
b
b
b
c
c
c
b
c
b
"}
(28,1,1) = {"
a
a
a
a
a
c
c
b
c
c
b
b
b
c
b
b
b
c
c
c
c
b
b
b
b
b
c
c
b
b
b
b
c
c
c
b
c
b
"}
(29,1,1) = {"
a
a
a
a
a
a
c
b
c
c
c
b
b
c
b
b
b
c
c
c
c
c
b
b
b
c
c
c
b
b
b
b
c
c
c
b
c
b
"}
(30,1,1) = {"
a
b
b
a
a
a
c
b
b
c
c
b
c
c
c
b
b
c
c
c
m
c
c
c
b
c
c
c
b
b
b
b
c
c
b
b
c
b
"}
(31,1,1) = {"
b
b
b
a
a
a
a
b
b
c
c
c
c
c
c
c
c
c
b
b
b
b
c
c
b
b
c
c
c
b
b
c
c
c
b
c
c
b
"}
(32,1,1) = {"
b
b
b
b
a
a
a
b
b
b
b
c
c
c
c
c
c
c
c
c
b
b
c
c
b
b
c
U
c
c
c
c
b
b
b
c
b
a
"}
(33,1,1) = {"
a
b
b
b
a
a
a
a
a
b
b
c
c
c
c
c
c
c
c
c
b
b
c
c
c
b
b
b
b
b
c
c
b
b
c
c
b
a
"}
(34,1,1) = {"
b
a
a
a
a
a
a
b
a
b
b
b
b
b
b
b
b
b
c
c
c
b
c
c
c
b
b
b
b
b
b
b
b
c
c
b
b
a
"}
(35,1,1) = {"
b
a
a
a
a
a
a
a
a
a
a
a
a
a
b
b
b
b
c
c
c
b
b
b
c
c
c
c
c
c
c
c
c
c
b
b
a
a
"}
(36,1,1) = {"
a
a
a
a
b
a
a
a
a
a
a
a
a
a
a
G
b
b
b
c
c
c
b
b
b
b
b
c
c
c
b
b
b
b
b
b
a
a
"}
(37,1,1) = {"
a
a
a
a
a
a
a
a
a
a
a
a
a
a
a
a
a
a
a
a
a
a
a
a
a
a
b
b
b
b
b
b
b
a
a
a
a
a
"}
